x x x x  x x  x x p  p x x x x x
x x x x  x x  x p p  p x x x x x
p p x x  p p  p p p  p x x x x x
p s p p  p p  x x p  x x x x x x
p p p p  x x  x x p  x x x p p p
x p p x  p p  p p S1 p p p p e p
x x p x  x x  x x S2 p x x p p p
x x p p  p x2 x x p  p x x x x x
x x x p  p p  x x p  p x x x x x
x x x x1 p p  p p p  p x x x x x
----
S1 toggles x1
S2 toggles x2
