    x x x x x x p p p p p p p x x
p p p p x x p p p x x p p x x 
p p p p p p p p p x x p p p p
p s p p x x x x x x x p p e p
p p p p x x x x x x x p p p p
x x x x x x x x x x x x p p p
x x x x x x x x x x x x x x x